25;purple;
############O############
############O############
############O############
###F........O........F###
###.##.####.#.####.##.###
###*##.####.#.####.##*###
###...................###
###.##.#.#######.#.##.###
###....#....#....#....###
######.####O#O####.######
######.OOOOOOOOOOO.######
######.#O###O###O#.######
OOOOOO.OOOOOPOOOOO.OOOOOO
######.#O###O###O#.######
######.OOOOOOOOOOO.######
######.#O###O###O#.######
###.........#.........###
###.##.####.#.####.##.###
###*.#......P......#.*###
####.#.#.#######.#.#.####
###....#....#....#....###
###.#######.#.#######.###
###F.................F###
############O############
############O############